  0   0   0
  0   0   0
  0   0   0
  0   0   0
  0   0   0
  0   0   0
  0   0   0
  0   0   0
  0   0   0
  0   0   0
  0   0   0
  0   0   0
  0   0   0
  0   0   0
  0   0   0
  0   0   0
  0   0   0
  0   0   0
  0   0   0
  0   0   0
  0   0   0
  0   0   0
  0   0   0
  0   0   0
  0   0   0
  0   0   0
  0   0   0
  0   0   0
  0   0   0
  0   0   0
  0   0   0
  0   0   0
  0   0   0
  0   0   0
  0   0   0
  0   0   0
  0   0   0
  0   0   0
  0   0   0
  0   0   0
  0   0   0
  0   0   0
  0   0   0
  0   0   0
  0   0   0
  0   0   0
  0   0   0
  0   0   0
  0   0   0
  0   0   0
  0   0   0
  0   0   0
  0   0   0
  0   0   0
  0   0   0
  0   0   0
  0   0   0
  0   0   0
  0   0   0
  0   0   0
  0   0   0
  0   0   0
  0   0   0
  0   0   0
  0   0   0
  0   0   0
  0   0   0
  0   0   0
  0   0   0
  0   0   0
  0   0   0
  0   0   0
  0   0   0
  0   0   0
  0   0   0
  0   0   0
  0   0   0
  0   0   0
  0   0   0
  0   0   0
  0   0   0
  0   0   0
  0   0   0
  0   0   0
  0   0   0
  0   0   0
  0   0   0
  0   0   0
  0   0   0
  0   0   0
  0   0   0
  0   0   0
  0   0   0
  0   0   0
  0   0   0
  0   0   0
  0   0   0
  0   0   0
  0   0   0
  0   0   0
  0   0   0
  0   0   0
  0   0   0
  0   0   0
  0   0   0
  0   0   0
  0   0   0
  0   0   0
  0   0   0
  0   0   0
  0   0   0
  0   0   0
  0   0   0
  0   0   0
  0   0   0
  0   0   0
  0   0   0
  0   0   0
  0   0   0
  0   0   0
  0   0   0
  0   0   0
  0   0   0
  0   0   0
  0   0   0
  0   0   0
  0   0   0
  0   0   0
  0   0   0
  0   0   0
  3   0   0
  6   0   0
  9   0   0
 12   0   0
 15   0   0
 18   0   0
 21   0   0
 24   0   0
 27   0   0
 30   0   0
 33   0   0
 36   0   0
 39   0   0
 42   0   0
 45   0   0
 48   0   0
 51   0   0
 54   0   0
 57   0   0
 60   0   0
 63   0   0
 66   0   0
 69   0   0
 72   0   0
 75   0   0
 78   0   0
 81   0   0
 84   0   0
 87   0   0
 90   0   0
 93   0   0
 96   0   0
 99   0   0
102   0   0
105   0   0
108   0   0
111   0   0
114   0   0
117   0   0
120   0   0
123   0   0
126   0   0
129   0   0
132   0   0
135   0   0
138   0   0
141   0   0
144   0   0
147   0   0
150   0   0
153   0   0
156   0   0
159   0   0
162   0   0
165   0   0
168   0   0
171   0   0
174   0   0
177   0   0
180   0   0
183   0   0
186   0   0
189   0   0
189   3   0
189   6   0
189   9   0
189  12   0
189  15   0
189  18   0
189  21   0
189  24   0
189  27   0
189  30   0
189  33   0
189  36   0
189  39   0
189  42   0
189  45   0
189  48   0
189  51   0
189  54   0
189  57   0
189  60   0
189  63   0
189  66   0
189  69   0
189  72   0
189  75   0
189  78   0
189  81   0
189  84   0
189  87   0
189  90   0
189  93   0
189  96   0
189  99   0
189 102   0
189 105   0
189 108   0
189 111   0
189 114   0
189 117   0
189 120   0
189 123   0
189 126   0
189 129   0
189 132   0
189 135   0
189 138   0
189 141   0
189 144   0
189 147   0
189 150   0
189 153   0
189 156   0
189 159   0
189 162   0
189 165   0
189 168   0
189 171   0
189 174   0
189 177   0
189 180   0
189 183   0
189 186   0
189 189   0
